Abgrund	masc	Abgründe
Abstand	masc	Abstände
Anfang	masc	Anfänge
Angst	fem	Ängste
Anhänger	masc	Anhänger
Apfel	masc	Äpfel
Apfel	masc	Äpfel
Arzt	masc	Ärzte
Ast	masc	Äste
Auftrag	masc	Aufträge
Axt	fem	Äxte
Bach	masc	Bäche
Bad	neutr	Bäder
Ball	masc	Bälle
Band	neutr	Bänder
Bank	fem	Bänke
Bart	masc	Bärte
Bauch	masc	Bäuche
Baum	masc	Bäume
Belag masc  Beläge
Blatt	neutr	Blätter
Block	masc	Blöcke
Bock	masc	Böcke
Bogen	masc	Bögen
Brand	masc	Brände
Bruch	masc	Brüche
Bruder	masc	Brüder
Buch	neutr	Bücher
Bund	masc	Bünde
Busch	masc	Büsche
Dach	neutr	Dächer
Damm	masc	Dämme
Dampf	masc	Dämpfe
Darm	masc	Därme
Dorf	neutr	Dörfer
Duft	masc	Düfte
Entschluss	masc	Entschlüsse
Faden	masc	Fäden
Fall	masc	Fälle
Fass	neutr	Fässer
Fenster	neutr	Fenster
Floh	masc	Flöhe
Fluch	masc	Flüche
Flug	masc	Flüge
Flügel	masc	Flügel
Fluss	masc	Flüsse
Frosch	masc	Frösche
Frucht	fem	Früchte
Fuchs	masc	Füchse
Furz	masc	Fürze
Fuß	masc	Füße
Gang	masc	Gänge
Gans	fem	Gänse
Garten	masc	Gärten
Garten	masc	Gärten
Gebäude	neutr	Gebäude
Gehalt	neutr	Gehälter
Geruch	masc	Gerüche
Glas	neutr	Gläser
Gott	masc	Götter
Grab	neutr	Gräber
Gras	neutr	Gräser
Grund	masc	Gründe
Gruß	masc	Grüsse
Guss	masc	Güsse
Hafen	masc	Häfen
Hahn	masc	Hähne
Hals	masc	Hälse
Hand	fem	Hände
Hang	masc	Hänge
Haus	neutr	Häuser
Hof	masc	Höfe
Holz	neutr	Hölzer
Horn	neutr	Hörner
Hut	masc	Hüte
Kalb	neutr	Kälber
Kamm	masc	Kämme
Kampf	masc	Kämpfe
Kanal	masc	Kanäle
Kasten	masc	Kästen
Kloß	masc	Klöße
Kloster	neutr	Klöster
Knopf	masc	Knöpfe
Koch	masc	Köche
Kopf	masc	Köpfe
Korb	masc	Körbe
Kraft	fem	Kräfte
Krampf	masc	Krämpfe
Kraut	neutr	Kräuter
Krug	masc	Krüge
Kuh	fem	Kühe
Kunst	fem	Künste
Kuss	masc	Küsse
Laden	masc	Läden
Lamm	neutr	Lämmer
Land	neutr	Länder
Laster	masc	Laster
Laster	fem	Laster
Lauf	masc	Läufe
Lehrer	masc	Lehrer
Loch	neutr	Löcher
Lohn	masc	Löhne
Luchs	masc	Lüchse
Luft	fem	Lüfte
Macht	fem	Mächte
Magen	masc	Mägen
Mann	masc	Männer
Mantel	masc	Mäntel
Maul	neutr	Mäuler
Maus	fem	Mäuse
Mund	masc	Münder
Mutter	fem	Mütter
Nacht	fem	Nächte
Nagel	masc	Nägel
Naht	fem	Nähte
Nuss	fem	Nüsse
Ofen	masc	Öfen
Pass	masc	Pässe
Pflock	masc	Pflöcke
Pflug	masc	Pflüge
Plan	masc	Pläne
Platz	masc	Plätze
Rad	neutr	Räder
Rand	masc	Ränder
Rang	masc	Ränge
Raum	masc	Räume
Rock	masc	Röcke
Ross	neutr	Rösser
Sack	masc	Säcke
Sänger	masc	Sänger
Sarg	masc	Särge
Satz	masc	Sätze
Sau	fem	Säue
Saum	masc	Säume
Schacht	masc	Schächte
Schatz	masc	Schätze
Schaum	masc	Schäume
Schlag	masc	Schläge
Schloss	neutr	Schlösser
Schlumpf	masc	Schlümpfe
Schnabel	masc	Schnäbel
Schnur	fem	Schnüre
Schrank	masc	Schränke
Schüler	masc	Schüler
Schuss	masc	Schüsse
Schwamm	masc	Schwämme
Schwan	masc	Schwäne
Schwanz	masc	Schwänze
Segel	neutr	Segel
Sohn	masc	Söhne
Spaß	masc	Späße
Stadt	fem	Städte
Stadt	fem	Städte
Stamm	masc	Stämme
Statt	fem	Stätte
Stock	masc	Stöcke
Storch	masc	Störche
Stoß	masc	Stöße
Strauch	masc	Sträucher
Strauß	masc	Sträuße
Strumpf	masc	Strümpfe
Stuhl	masc	Stühle
Stumpf	masc	Stümpfe
Sturm	masc	Stürme
Sumpf	masc	Sümpfe
Tanz	masc	Tänze
Tochter	fem	Töchter
Tochter	fem	Töchter
Ton	masc	Töne
Topf	masc	Töpfe
Traum	masc	Träume
Tuch	neutr	Tücher
Tür	fem	Türen
Turm	masc	Türme
Vater	masc	Väter
Verband	masc	Verbände
Verschluss	masc	Verschlüsse
Vogel	masc	Vögel
Vogel	masc	Vögel
Volk	neutr	Völker
Vorrat	masc	Vorräte
Vortrag	masc	Vorträge
Wald	masc	Wälder
Wand	fem	Wände
Wolf	masc	Wölfe
Wort	neutr	Wörter
Wurf	masc	Würfe
Wurm	masc	Würmer
Wurst	fem	Würste
Zahn	masc	Zähne
Zaun	masc	Zäune
Zopf	masc	Zöpfe
Zug	masc	Züge
